Bulbasaur: Sleep Powder, Giga Drain, Growth, Hidden Power Fire, Hidden Power Ice, Sludge Bomb, Swords Dance, Power Whip, Leech Seed, Synthesis
Ivysaur: Sleep Powder, Giga Drain, Growth, Hidden Power Fire, Hidden Power Ice, Sludge Bomb, Swords Dance, Power Whip, Leech Seed, Synthesis
Venusaur: Sleep Powder, Giga Drain, Growth, Hidden Power Fire, Hidden Power Ice, Sludge Bomb, Swords Dance, Power Whip, Leech Seed, Synthesis, Earthquake
Charmander: Flamethrower, Overheat, Dragon Pulse, Hidden Power Grass, Fire Blast
Charmeleon: Flamethrower, Overheat, Dragon Pulse, Hidden Power Grass, Fire Blast
Charizard: Flamethrower, Fire Blast, Substitute, Air Slash, Dragon Pulse, Hidden Power Grass, Roost
Squirtle: Surf, Ice Beam, Hydro Pump, Rapid Spin, Scald, Aqua Jet, Toxic
Wartortle: Surf, Ice Beam, Hydro Pump, Rapid Spin, Scald, Aqua Jet, Toxic
Blastoise: Surf, Ice Beam, Hydro Pump, Rapid Spin, Scald, Aqua Jet, Toxic, Dragon Tail
Caterpie: Bug Bite, Snore, Tackle, Electroweb
Metapod: Iron Defense, Bug Bite, Tackle, Electroweb
Butterfree: Quiver Dance, Roost, Bug Buzz, Air Slash, Substitute, Sleep Powder, Giga Drain, Stun Spore, U-turn
Weedle: Bug Bite, String Shot, Poison Sting, Electroweb
Kakuna: Electroweb, Bug Bite, Iron Defense, Poison Sting
Beedrill: Toxic Spikes, X-Scissor, Swords Dance, U-turn, Endeavor, Poison Jab, Drill Run, Night Slash, Brick Break
Pidgey: Roost, Brave Bird, Heat Wave, Hurricane, Return, Work Up, U-turn
Pidgeotto: Roost, Brave Bird, Heat Wave, Hurricane, Return, Work Up, U-turn
Pidgeot: Roost, Brave Bird, Pursuit, Heat Wave, Return, Work Up, U-turn
Rattata: Facade, Flame Wheel, Wild Charge, Sucker Punch, U-turn
Raticate: Facade, Flame Wheel, Wild Charge, Sucker Punch, U-turn
Spearow: Return, Drill Peck, Double-Edge, U-turn, Quick Attack, Pursuit
Fearow: Return, Drill Peck, Double-Edge, U-turn, Quick Attack, Pursuit, Drill Run, Roost
Ekans: Coil, Gunk Shot, Seed Bomb, Glare, Sucker Punch, Aqua Tail, Crunch, Earthquake, Rest
Arbok: Coil, Gunk Shot, Seed Bomb, Glare, Sucker Punch, Aqua Tail, Crunch, Earthquake, Rest
Pichu: Fake Out, Volt Tackle, Encore, Iron Tail, Toxic, ThunderPunch
Pikachu: Thunderbolt, Volt Tackle, Grass Knot, Hidden Power Ice, Brick Break, ExtremeSpeed, Encore, Substitute
Raichu: Nasty Plot, Encore, Thunderbolt, Grass Knot, Hidden Power Ice, Focus Blast, Substitute, ExtremeSpeed
Sandshrew: Earthquake, Stone Edge, Swords Dance, Rapid Spin, Night Slash, X-Scissor, Stealth Rock, Toxic
Sandslash: Earthquake, Stone Edge, Swords Dance, Rapid Spin, Night Slash, X-Scissor, Stealth Rock, Toxic
NidoranF: Toxic Spikes, Crunch, Poison Jab, Hone Claws
Nidorina: Toxic Spikes, Crunch, Poison Jab, Hone Claws, Ice Beam
Nidoqueen: Toxic Spikes, Stealth Rock, Fire Blast, Thunderbolt, Ice Beam, Earth Power, Sludge Wave, Focus Blast
NidoranM: Sucker Punch, Poison Jab, Head Smash, Hone Claws
Nidorino: Sucker Punch, Poison Jab, Head Smash, Hone Claws
Nidoking: Fire Blast, Thunderbolt, Ice Beam, Earth Power, Sludge Wave, Focus Blast
Cleffa: Reflect, Thunder Wave, Light Screen, Toxic, Fire Blast, Encore, Wish, Protect, Aromatherapy
Clefairy: Healing Wish, Reflect, Thunder Wave, Light Screen, Toxic, Fire Blast, Encore, Wish, Protect, Aromatherapy, Stealth Rock
Clefable: Calm Mind, Hyper Voice, Softboiled, Stored Power
Vulpix: Flamethrower, Fire Blast, Will-O-Wisp, SolarBeam, Nasty Plot, Substitute, Toxic, Hypnosis, Pain Split
Ninetales: Flamethrower, Fire Blast, Will-O-Wisp, SolarBeam, Nasty Plot, Substitute, Toxic, Hypnosis, Pain Split
Igglybuff: Wish, Thunder Wave, Reflect, Light Screen, Heal Bell, Seismic Toss, Counter, Protect
Jigglypuff: Wish, Thunder Wave, Reflect, Light Screen, Heal Bell, Seismic Toss, Counter, Stealth Rock, Protect
Wigglytuff: Wish, Thunder Wave, Return, Thunderbolt, Heal Bell, Fire Blast, Counter, Stealth Rock, Ice Beam
Zubat: Brave Bird, Roost, Toxic, Taunt, Nasty Plot, Giga Drain, Sludge Bomb, Air Slash, U-turn, Whirlwind, Acrobatics, Heat Wave, Super Fang
Golbat: Brave Bird, Roost, Toxic, Taunt, Nasty Plot, Giga Drain, Sludge Bomb, Air Slash, U-turn, Whirlwind, Acrobatics, Heat Wave, Super Fang
Crobat: Brave Bird, Roost, Toxic, Taunt, Nasty Plot, Giga Drain, Sludge Bomb, Air Slash, U-turn, Whirlwind, Acrobatics, Heat Wave, Super Fang
Oddish: Giga Drain, Sludge Bomb, Synthesis, Sleep Powder, Stun Spore, Toxic, Hidden Power Fire, Leech Seed
Gloom: Giga Drain, Sludge Bomb, Synthesis, Sleep Powder, Stun Spore, Toxic, Hidden Power Fire, Leech Seed
Vileplume: Giga Drain, Sludge Bomb, Synthesis, Sleep Powder, Stun Spore, Toxic, Hidden Power Fire, Leech Seed, Aromatherapy
Bellossom: Giga Drain, Sludge Bomb, Synthesis, Sleep Powder, Stun Spore, Toxic, Hidden Power Fire, Leech Seed, Aromatherapy, Leaf Storm
Paras: Spore, Stun Spore, X-Scissor, Seed Bomb, Synthesis, Leech Seed, Aromatherapy
Parasect: Spore, Stun Spore, X-Scissor, Seed Bomb, Synthesis, Leech Seed, Aromatherapy
Venonat: Sleep Powder, Morning Sun, Toxic Spikes, Sludge Bomb, Signal Beam, Stun Spore
Venomoth: Sleep Powder, Roost, Toxic Spikes, Quiver Dance, Baton Pass, Bug Buzz, Sludge Bomb, Giga Drain, Substitute
Diglett: Earthquake, Rock Slide, Stealth Rock, Sucker Punch, Reversal, Substitute
Dugtrio: Earthquake, Stone Edge, Stealth Rock, Sucker Punch, Reversal, Substitute
Meowth: Fake Out, U-turn, Bite, Taunt, Return, Hypnosis, Water Pulse
Persian: Fake Out, U-turn, Bite, Taunt, Return, Hypnosis, Water Pulse, Switcheroo
Psyduck: Hydro Pump, Surf, Ice Beam, Hidden Power Grass, Cross Chop, Encore
Golduck: Hydro Pump, Surf, Ice Beam, Hidden Power Grass, Encore, Focus Blast
Mankey: Close Combat, U-turn, Ice Punch, Rock Slide, Punishment
Primeape: Close Combat, U-turn, Ice Punch, Stone Edge, Punishment, Encore
Growlithe: Flare Blitz, Wild Charge, Hidden Power Grass, Hidden Power Ice, Close Combat, Morning Sun, Will-O-Wisp, Toxic
Arcanine: Flare Blitz, Wild Charge, Hidden Power Grass, Hidden Power Ice, ExtremeSpeed, Close Combat, Morning Sun, Will-O-Wisp, Toxic
Poliwag: Hydro Pump, Ice Beam, Encore, Belly Drum, Hypnosis, Waterfall, Return
Poliwhirl: Hydro Pump, Ice Beam, Encore, Belly Drum, Hypnosis, Waterfall, Return
Poliwrath: Substitute, Circle Throw, Focus Punch, Bulk Up, Encore, Waterfall, Toxic, Rest, Sleep Talk, Ice Punch
Politoed: Scald, Hypnosis, Toxic, Encore, Perish Song, Protect, Ice Beam, Focus Blast, Surf, Hydro Pump, Hidden Power Grass
Abra: Calm Mind, Psychic, Psyshock, Hidden Power Fighting, Shadow Ball, Encore, Substitute
Kadabra: Calm Mind, Psychic, Psyshock, Hidden Power Fighting, Shadow Ball, Encore, Substitute
Alakazam: Calm Mind, Psychic, Psyshock, Focus Blast, Shadow Ball, Encore, Substitute
Machop: DynamicPunch, Payback, Bulk Up, Ice Punch, Rock Slide, Bullet Punch
Machoke: DynamicPunch, Payback, Bulk Up, Ice Punch, Rock Slide, Bullet Punch
Machamp: DynamicPunch, Payback, Bulk Up, Ice Punch, Stone Edge, Bullet Punch
Bellsprout: Swords Dance, Sleep Powder, Sunny Day, Growth, SolarBeam, Giga Drain, Sludge Bomb, Weather Ball, Sucker Punch, Seed Bomb
Weepinbell: Swords Dance, Sleep Powder, Sunny Day, Growth, SolarBeam, Giga Drain, Sludge Bomb, Weather Ball, Sucker Punch, Seed Bomb
Victreebel: Swords Dance, Sleep Powder, Sunny Day, Growth, SolarBeam, Giga Drain, Sludge Bomb, Weather Ball, Sucker Punch, Power Whip
Tentacool: Toxic Spikes, Rapid Spin, Scald, Sludge Bomb, Ice Beam, Knock Off, Giga Drain, Toxic
Tentacruel: Toxic Spikes, Rapid Spin, Scald, Sludge Bomb, Ice Beam, Knock Off, Giga Drain, Toxic
Geodude: Stealth Rock, Earthquake, Stone Edge, Sucker Punch, Hammer Arm, Fire Punch
Graveler: Stealth Rock, Earthquake, Stone Edge, Sucker Punch, Hammer Arm, Fire Punch
Golem: Stealth Rock, Earthquake, Stone Edge, Sucker Punch, Hammer Arm, Fire Punch
Ponyta: Flare Blitz, Wild Charge, Morning Sun, Hypnosis, Flame Charge
Rapidash: Flare Blitz, Wild Charge, Morning Sun, Hypnosis, Flame Charge, Megahorn, Drill Run
Slowpoke: Scald, Aqua Tail, Zen Headbutt, Thunder Wave, Toxic, Slack Off, Trick Room, Trick
Slowbro: Scald, Surf, Fire Blast, Ice Beam, Psychic, Grass Knot, Calm Mind, Thunder Wave, Toxic, Slack Off, Trick Room, Trick
Slowking: Scald, Surf, Fire Blast, Ice Beam, Psychic, Grass Knot, Calm Mind, Thunder Wave, Toxic, Slack Off, Trick Room, Trick, Nasty Plot
Magnemite: Thunderbolt, Thunder Wave, Magnet Rise, Substitute, Flash Cannon, Hidden Power Ice, Volt Switch
Magneton: Thunderbolt, Thunder Wave, Magnet Rise, Substitute, Flash Cannon, Hidden Power Ice, Volt Switch
Magnezone: Thunderbolt, Thunder Wave, Magnet Rise, Substitute, Flash Cannon, Hidden Power Ice, Volt Switch
Farfetch'd: Brave Bird, Swords Dance, Return, Leaf Blade, Roost
Doduo: Brave Bird, Return, Double-Edge, Roost, Quick Attack, Pursuit
Dodrio: Brave Bird, Return, Double-Edge, Roost, Quick Attack, Pursuit
Seel: Surf, Ice Beam, Aqua Jet, Ice Shard, Rain Dance, Protect, Rest, Toxic, Drill Run
Dewgong: Surf, Ice Beam, Aqua Jet, Ice Shard, Rain Dance, Protect, Rest, Toxic, Drill Run
Grimer: Curse, Gunk Shot, Poison Jab, Shadow Sneak, Payback, Brick Break, Rest, Ice Punch, Fire Punch, Sleep Talk
Muk: Curse, Gunk Shot, Poison Jab, Shadow Sneak, Payback, Brick Break, Rest, Ice Punch, Fire Punch, Sleep Talk
Shellder: Shell Smash, Hydro Pump, Razor Shell, Rock Blast, Icicle Spear, Rapid Spin
Cloyster: Shell Smash, Hydro Pump, Razor Shell, Rock Blast, Icicle Spear, Ice Shard, Rapid Spin, Spikes, Toxic Spikes
Gastly: Shadow Ball, Sludge Bomb, Hidden Power Fighting, Thunderbolt, Substitute, Disable, Pain Split, Hypnosis, Giga Drain, Trick
Haunter: Shadow Ball, Sludge Bomb, Hidden Power Fighting, Thunderbolt, Substitute, Disable, Pain Split, Hypnosis, Giga Drain, Trick
Gengar: Shadow Ball, Sludge Bomb, Focus Blast, Thunderbolt, Substitute, Disable, Pain Split, Hypnosis, Giga Drain, Trick
Onix: Stealth Rock, Earthquake, Stone Edge, Dragon Tail, Curse
Steelix: Stealth Rock, Earthquake, Iron Head, Curse, Roar, Toxic, Rock Slide, Ice Fang, Fire Fang
Drowzee: Psychic, Seismic Toss, Thunder Wave, Wish, Protect, Heal Bell, Toxic, Nasty Plot, Shadow Ball, Trick Room, Calm Mind, Barrier
Hypno: Psychic, Seismic Toss, Thunder Wave, Wish, Protect, Heal Bell, Toxic, Nasty Plot, Shadow Ball, Trick Room, Baton Pass, Calm Mind, Barrier, Belly Drum, Zen Headbutt, Fire Punch
Krabby: Crabhammer, Return, Swords Dance, Agility, Rock Slide, Substitute, X-Scissor, Superpower
Kingler: Crabhammer, Return, Swords Dance, Agility, Rock Slide, Substitute, X-Scissor, Superpower
Voltorb: Volt Switch, Thunderbolt, Taunt, Foul Play, Hidden Power Ice
Electrode: Volt Switch, Thunderbolt, Taunt, Foul Play, Hidden Power Ice
Exeggcute: Substitute, Leech Seed, Giga Drain, Psychic, Sleep Powder, Stun Spore, Hidden Power Fire, Synthesis
Exeggutor: Substitute, Leech Seed, Giga Drain, Leaf Storm, Psychic, Sleep Powder, Stun Spore, Hidden Power Fire, Synthesis
Cubone: Substitute, Bonemerang, Double-Edge, Rock Slide, Fire Punch, Earthquake
Marowak: Substitute, Bonemerang, Double-Edge, Stone Edge, Swords Dance, Fire Punch, Earthquake
Tyrogue: Hi Jump Kick, Rapid Spin, Fake Out, Bullet Punch, Mach Punch, Toxic, Counter
Hitmonlee: Hi Jump Kick, Sucker Punch, Stone Edge, Mach Punch, Substitute, Fake Out, Close Combat, Earthquake, Blaze Kick
Hitmonchan: Bulk Up, Drain Punch, Ice Punch, Mach Punch, Substitute, Close Combat, Stone Edge, Rapid Spin
Hitmontop: Fake Out, Sucker Punch, Mach Punch, Bulk Up, Rapid Spin, Close Combat, Stone Edge, Toxic, Bullet Punch
Lickitung: Wish, Protect, Dragon Tail, Curse, Body Slam, Return, Power Whip, Swords Dance, Earthquake, Toxic, Heal Bell
Lickilicky: Wish, Protect, Dragon Tail, Curse, Body Slam, Return, Power Whip, Swords Dance, Earthquake, Toxic, Heal Bell, Explosion
Koffing: Pain Split, Sludge Bomb, Will-O-Wisp, Fire Blast, Toxic, Clear Smog, Rest, Sleep Talk, Thunderbolt
Weezing: Pain Split, Sludge Bomb, Will-O-Wisp, Fire Blast, Toxic, Clear Smog, Rest, Sleep Talk, Thunderbolt
Rhyhorn: Stone Edge, Earthquake, Aqua Tail, Megahorn, Stealth Rock, Rock Blast
Rhydon: Stone Edge, Earthquake, Aqua Tail, Megahorn, Stealth Rock, Rock Blast
Rhyperior: Stone Edge, Earthquake, Aqua Tail, Megahorn, Stealth Rock, Rock Blast
Happiny: Aromatherapy, Toxic, Thunder Wave, Counter, Endeavor
Chansey: Wish, Softboiled, Protect, Toxic, Aromatherapy, Seismic Toss, Counter, Thunder Wave, Stealth Rock
Blissey: Wish, Softboiled, Protect, Toxic, Aromatherapy, Seismic Toss, Counter, Thunder Wave, Stealth Rock, Flamethrower, Ice Beam
Tangela: Giga Drain, Sleep Powder, Hidden Power Rock, Hidden Power Ice, Leech Seed, Knock Off, Leaf Storm, Stun Spore, Synthesis
Tangrowth: Giga Drain, Sleep Powder, Hidden Power Rock, Hidden Power Ice, Leech Seed, Knock Off, Leaf Storm, Stun Spore, Focus Blast, Synthesis, Power Whip
Kangaskhan: Fake Out, Return, Hammer Arm, Double-Edge, Sucker Punch, Earthquake, Substitute, Focus Punch, Wish
Horsea: Hydro Pump, Ice Beam, Substitute, Hidden Power Grass, Rain Dance
Seadra: Hydro Pump, Ice Beam, Agility, Substitute, Hidden Power Grass
Kingdra: Hydro Pump, Ice Beam, Dragon Dance, Substitute, Outrage, Draco Meteor, Waterfall, Rest, Sleep Talk
Goldeen: Rain Dance, Waterfall, Megahorn, Return, Drill Run
Seaking: Rain Dance, Waterfall, Megahorn, Return, Drill Run
Staryu: Surf, Thunderbolt, Ice Beam, Rapid Spin, Recover
Starmie: Surf, Thunderbolt, Ice Beam, Rapid Spin, Recover, Psychic, Trick
Mime Jr.: Substitute, Baton Pass, Psychic, Hidden Power Fighting, Healing Wish, Nasty Plot, Thunderbolt, Encore
Mr. Mime: Substitute, Baton Pass, Psychic, Hidden Power Fighting, Healing Wish, Nasty Plot, Thunderbolt, Encore
Scyther: Swords Dance, Roost, Bug Bite, Quick Attack, Brick Break, Aerial Ace, Baton Pass, U-turn
Scizor: Swords Dance, Roost, Bullet Punch, Bug Bite, Superpower, U-turn, Baton Pass, Pursuit
Smoochum: Ice Beam, Psychic, Hidden Power Fighting, Trick, Shadow Ball, Grass Knot
Jynx: Ice Beam, Psychic, Focus Blast, Trick, Shadow Ball, Nasty Plot, Lovely Kiss, Substitute, Energy Ball
Elekid: Thunderbolt, Cross Chop, Volt Switch, Substitute, Hidden Power Ice, Psychic
Electabuzz: Thunderbolt, Volt Switch, Substitute, Hidden Power Ice, Focus Blast, Psychic
Electivire: Wild Charge, Cross Chop, Ice Punch, Substitute, Flamethrower, Earthquake
Magby: Flare Blitz, Substitute, Fire Blast, Hidden Power Grass, Cross Chop, ThunderPunch, Overheat
Magmar: Flare Blitz, Substitute, Fire Blast, Hidden Power Grass, Cross Chop, ThunderPunch, Overheat, Focus Blast
Magmortar: Fire Blast, Substitute, Focus Blast, Hidden Power Grass, Thunderbolt, Overheat
Pinsir: Swords Dance, X-Scissor, Earthquake, Close Combat, Stealth Rock, Substitute, Stone Edge, Quick Attack
Tauros: Return, Earthquake, Zen Headbutt, Rock Slide, Pursuit
Magikarp: Bounce, Flail, Tackle, Splash
Gyarados: Dragon Dance, Waterfall, Earthquake, Bounce, Rest, Sleep Talk, Dragon Tail, Stone Edge, Substitute, Thunder Wave, Ice Fang
Lapras: Ice Beam, Thunderbolt, Heal Bell, Toxic, Surf, Dragon Dance, Substitute, Waterfall, Return, Avalanche, Rest, Sleep Talk, Curse, Ice Shard, Drill Run
Ditto: Transform
Eevee: Quick Attack, Return, Bite, Baton Pass, Iron Tail, Yawn, Protect, Wish
Vaporeon: Wish, Protect, Scald, Roar, Ice Beam, Toxic, Baton Pass, Substitute, Acid Armor, Hydro Pump, Hidden Power Grass, Rest, Rain Dance
Jolteon: Thunderbolt, Volt Switch, Hidden Power Grass, Hidden Power Ice, Charge Beam, Baton Pass, Substitute
Flareon: Rest, Sleep Talk, Flame Charge, Facade
Espeon: Psychic, Psyshock, Substitute, Wish, Shadow Ball, Hidden Power Fighting, Calm Mind, Morning Sun, Stored Power, Baton Pass
Umbreon: Curse, Payback, Moonlight, Wish, Protect, Heal Bell, Toxic, Baton Pass
Leafeon: Swords Dance, Leaf Blade, Substitute, Return, X-Scissor, Yawn, Roar, Heal Bell, Baton Pass
Glaceon: Ice Beam, Hidden Power Ground, Shadow Ball, Wish, Protect
Porygon: Tri Attack, Ice Beam, Recover, Toxic, Thunder Wave, Discharge, Trick
Porygon2: Tri Attack, Ice Beam, Recover, Toxic, Thunder Wave, Discharge, Trick
Porygon-Z: Tri Attack, Thunderbolt, Ice Beam, Dark Pulse, Hidden Power Fighting, Agility, Trick, Nasty Plot
Omanyte: Shell Smash, Surf, Ice Beam, Earth Power, Hidden Power Electric, Spikes, Toxic Spikes, Stealth Rock, Hydro Pump
Omastar: Shell Smash, Surf, Ice Beam, Earth Power, Hidden Power Electric, Spikes, Toxic Spikes, Stealth Rock, Hydro Pump
Kabuto: Aqua Jet, Rock Slide, Rapid Spin, Stealth Rock, Hone Claws, Waterfall, Toxic
Kabutops: Aqua Jet, Stone Edge, Rapid Spin, Stealth Rock, Swords Dance, Waterfall, Toxic, Superpower
Aerodactyl: Stealth Rock, Taunt, Stone Edge, Rock Slide, Earthquake, Aqua Tail, Roost, Fire Fang
Munchlax: Rest, Curse, Sleep Talk, Body Slam, Earthquake, Return, Fire Punch, Ice Punch, Whirlwind
Snorlax: Rest, Curse, Sleep Talk, Body Slam, Earthquake, Return, Fire Punch, Ice Punch, Crunch, Selfdestruct, Pursuit, Whirlwind
Articuno: Ice Beam, Roost, Roar, Heal Bell, Toxic, Substitute, Hurricane
Zapdos: Thunderbolt, Heat Wave, Hidden Power Grass, Hidden Power Ice, Roost, Toxic, Substitute
Moltres: Fire Blast, Hidden Power Grass, Air Slash, Roost, Substitute, Toxic, U-turn, Will-O-Wisp, Hurricane
Dratini: Dragon Dance, Outrage, Waterfall, Fire Blast, ExtremeSpeed, Draco Meteor, Substitute, Aqua Tail
Dragonair: Dragon Dance, Outrage, Waterfall, Fire Blast, ExtremeSpeed, Draco Meteor, Substitute, Aqua Tail
Dragonite: Dragon Dance, Outrage, Fire Punch, ExtremeSpeed, Dragon Claw, Earthquake, Roost, Waterfall, Substitute, Thunder Wave, Dragon Tail, Hurricane, Superpower, Draco Meteor
Mewtwo: Psystrike, Aura Sphere, Fire Blast, Ice Beam, Calm Mind, Substitute, Recover, Thunderbolt
Mew: Taunt, Will-O-Wisp, Roost, Psychic, Nasty Plot, Aura Sphere, Fire Blast, Swords Dance, Superpower, Zen Headbutt, Baton Pass, Rock Polish, Substitute, Toxic, Ice Beam, Thunderbolt, Earthquake, U-turn, Stealth Rock
Chikorita: Reflect, Light Screen, Safeguard, Aromatherapy, GrassWhistle, Leech Seed, Toxic, Giga Drain, Synthesis
Bayleef: Reflect, Light Screen, Safeguard, Aromatherapy, GrassWhistle, Leech Seed, Toxic, Giga Drain, Synthesis
Meganium: Reflect, Light Screen, Safeguard, Aromatherapy, GrassWhistle, Leech Seed, Toxic, Giga Drain, Synthesis, Dragon Tail
Cyndaquil: Eruption, Fire Blast, Flamethrower, Hidden Power Grass, Nature Power
Quilava: Eruption, Fire Blast, Flamethrower, Hidden Power Grass, Nature Power
Typhlosion: Eruption, Fire Blast, Flamethrower, Hidden Power Grass, Nature Power, Focus Blast
Totodile: Aqua Jet, Waterfall, Crunch, Ice Punch, Superpower, Dragon Dance, Swords Dance
Croconaw: Aqua Jet, Waterfall, Crunch, Ice Punch, Superpower, Dragon Dance, Swords Dance
Feraligatr: Aqua Jet, Waterfall, Crunch, Ice Punch, Dragon Dance, Swords Dance, Earthquake, Superpower
Sentret: Super Fang, Trick, Toxic, U-turn, Knock Off
Furret: Return, U-turn, Sucker Punch, Trick, Ice Punch, Fire Punch, ThunderPunch
Hoothoot: Reflect, Toxic, Roost, Light Screen, Whirlwind, Night Shade, Magic Coat
Noctowl: Roost, Whirlwind, Air Slash, Night Shade, Toxic, Reflect, Light Screen, Magic Coat
Ledyba: Roost, Agility, Light Screen, Encore, Reflect, Knock Off, Swords Dance, Baton Pass, Toxic
Ledian: Roost, Bug Buzz, Light Screen, Encore, Reflect, Knock Off, Toxic
Spinarak: Agility, Toxic, X-Scissor, Toxic Spikes, Poison Jab, Baton Pass, Swords Dance
Ariados: Agility, Toxic, X-Scissor, Toxic Spikes, Poison Jab, Baton Pass, Swords Dance
Chinchou: Volt Switch, Thunderbolt, Hidden Power Grass, Hydro Pump, Ice Beam, Surf, Thunder Wave, Scald, Discharge
Lanturn: Volt Switch, Thunderbolt, Hidden Power Grass, Hydro Pump, Ice Beam, Surf, Thunder Wave, Scald, Discharge
Togepi: Protect, Fire Blast, Toxic, Thunder Wave, Softboiled
Togetic: Nasty Plot, Hyper Voice, Fire Blast, Baton Pass, Roost
Togekiss: Wish, Roost, Thunder Wave, Nasty Plot, Air Slash, Aura Sphere, Baton Pass
Natu: Thunder Wave, Roost, Toxic, Reflect, Light Screen, U-turn, Wish, Psychic, Night Shade
Xatu: Thunder Wave, Toxic, Roost, Psychic, Night Shade, U-turn, Reflect, Light Screen, Wish, Calm Mind
Mareep: Reflect, Light Screen, Thunderbolt, Discharge, Thunder Wave, Toxic, Hidden Power Ice, Cotton Guard
Flaaffy: Reflect, Light Screen, Thunderbolt, Discharge, Thunder Wave, Toxic, Hidden Power Ice, Cotton Guard
Ampharos: Volt Switch, Focus Blast, Hidden Power Ice, Hidden Power Grass, Thunderbolt, Heal Bell
Azurill: Scald, Return, Double-Edge, Encore, Toxic, Protect
Marill: Waterfall, Return, Double-Edge, Encore, Toxic, Aqua Jet, Superpower, Ice Punch, Protect
Azumarill: Waterfall, Aqua Jet, Return, Double-Edge, Ice Punch, Superpower
Bonsly: Rock Slide, Brick Break, Double-Edge, Toxic, Stealth Rock, Sucker Punch
Sudowoodo: Hammer Arm, Stone Edge, Earthquake, Sucker Punch, Wood Hammer, Explosion, Stealth Rock
Hoppip: Encore, Sleep Powder, U-turn, Toxic, Leech Seed, Substitute, Protect
Skiploom: Encore, Sleep Powder, U-turn, Toxic, Leech Seed, Substitute, Protect
Jumpluff: Encore, Sleep Powder, U-turn, Toxic, Leech Seed, Substitute, Giga Drain, Acrobatics, Synthesis
Aipom: Fake Out, Return, Brick Break, Seed Bomb, Shadow Claw, U-turn
Ambipom: Fake Out, Return, Payback, U-turn, Low Sweep, Switcheroo, Seed Bomb
Sunkern: Sunny Day, Giga Drain, SolarBeam, Hidden Power Fire, Toxic, Earth Power
Sunflora: Sunny Day, Leaf Storm, Giga Drain, SolarBeam, Hidden Power Fire, Earth Power
Yanma: Bug Buzz, Air Slash, Hidden Power Ground, U-turn, Protect, Giga Drain
Yanmega: Bug Buzz, Air Slash, Hidden Power Ground, U-turn, Protect, Giga Drain
Wooper: Recover, Earthquake, Scald, Toxic, Stockpile, Yawn, Protect
Quagsire: Recover, Earthquake, Waterfall, Scald, Toxic, Curse, Stone Edge, Stockpile, Yawn
Murkrow: Substitute, Sucker Punch, Brave Bird, Heat Wave, Hidden Power Grass, Roost, Dark Pulse, Thunder Wave
Honchkrow: Substitute, Superpower, Sucker Punch, Brave Bird, Roost, Hidden Power Grass, Heat Wave, Pursuit
Misdreavus: Nasty Plot, Substitute, Calm Mind, Will-O-Wisp, Shadow Ball, Thunderbolt, Hidden Power Fighting
Mismagius: Nasty Plot, Substitute, Calm Mind, Will-O-Wisp, Shadow Ball, Thunderbolt, Hidden Power Fighting
Unown: Hidden Power Psychic
Wynaut: Destiny Bond, Counter, Mirror Coat, Encore
Wobbuffet: Destiny Bond, Counter, Mirror Coat, Encore
Girafarig: Psychic, Thunderbolt, Calm Mind, Baton Pass, Agility, Hyper Voice, Thunder Wave
Pineco: Rapid Spin, Toxic Spikes, Spikes, Bug Bite, Stealth Rock
Forretress: Rapid Spin, Toxic Spikes, Spikes, Bug Bite, Earthquake, Volt Switch, Stealth Rock
Dunsparce: Coil, Rock Slide, Bite, Headbutt, Glare, Thunder Wave, Body Slam, Roost
Gligar: Stealth Rock, Toxic, Roost, Taunt, Swords Dance, Earthquake, U-turn, Stone Edge, Acrobatics
Gliscor: Swords Dance, Acrobatics, Earthquake, Roost, Substitute, Taunt, Ice Fang, Protect, Toxic, Stealth Rock
Snubbull: Thunder Wave, Return, Crunch, Close Combat
Granbull: Thunder Wave, Return, Crunch, Close Combat, Heal Bell, Ice Punch
Qwilfish: Toxic Spikes, Waterfall, Spikes, Swords Dance, Poison Jab, Pain Split, Thunder Wave, Taunt, Destiny Bond
Shuckle: Rollout, Acupressure, Power Split, Rest
Heracross: Close Combat, Megahorn, Stone Edge, Swords Dance, Facade
Sneasel: Ice Shard, Ice Punch, Night Slash, Low Kick, Pursuit, Swords Dance
Weavile: Ice Shard, Ice Punch, Night Slash, Low Kick, Pursuit, Swords Dance
Teddiursa: Swords Dance, Protect, Facade, Close Combat, Fire Punch, Crunch
Ursaring: Swords Dance, Protect, Facade, Close Combat, Fire Punch, Crunch
Slugma: Stockpile, Recover, Lava Plume, Will-O-Wisp, Toxic, Hidden Power Grass
Magcargo: Stockpile, Recover, Lava Plume, Will-O-Wisp, Toxic, Hidden Power Grass, Hidden Power Rock, Stealth Rock, Shell Smash, Fire Blast, Earth Power
Swinub: Earthquake, Icicle Crash, Ice Shard, Superpower, Endeavor, Stealth Rock
Piloswine: Earthquake, Icicle Crash, Ice Shard, Superpower, Endeavor, Stealth Rock
Mamoswine: Ice Shard, Earthquake, Endeavor, Icicle Crash, Stone Edge, Superpower, Stealth Rock
Corsola: Recover, Toxic, Power Gem, Scald, Stealth Rock
Remoraid: Water Spout, Hydro Pump, Fire Blast, Hidden Power Ground, Ice Beam, Seed Bomb, Rock Blast
Octillery: Hydro Pump, Fire Blast, Ice Beam, Energy Ball, Rock Blast, Thunder Wave
Delibird: Rapid Spin, Ice Shard, Ice Punch, Aerial Ace
Mantyke: Rain Dance, Hydro Pump, Surf, Air Slash, Ice Beam, Rest, Sleep Talk, Toxic
Mantine: Rain Dance, Hydro Pump, Surf, Air Slash, Ice Beam, Rest, Sleep Talk, Toxic
Skarmory: Whirlwind, Brave Bird, Roost, Spikes, Stealth Rock
Houndour: Pursuit, Sucker Punch, Fire Blast, Dark Pulse, Hidden Power Fighting, Nasty Plot
Houndoom: Nasty Plot, Pursuit, Dark Pulse, Sucker Punch, Fire Blast, Hidden Power Fighting
Phanpy: Stealth Rock, Earthquake, Ice Shard, Head Smash, Knock Off, Seed Bomb, Superpower
Donphan: Stealth Rock, Rapid Spin, Ice Shard, Earthquake, Head Smash, Seed Bomb, Superpower
Stantler: Return, Megahorn, Jump Kick, Earthquake, Thunder Wave, Sucker Punch
Smeargle: Spore, Spikes, Stealth Rock, U-turn, Destiny Bond, Whirlwind
Miltank: Milk Drink, Stealth Rock, Body Slam, Heal Bell, Curse, Earthquake
Raikou: Thunderbolt, Hidden Power Ice, Aura Sphere, Calm Mind, Substitute
Entei: ExtremeSpeed, Flare Blitz, Iron Head, Flame Charge, Stone Edge
Suicune: Hydro Pump, Ice Beam, Scald, Hidden Power Grass, Hidden Power Electric, Rest, Sleep Talk, Roar, Calm Mind
Larvitar: Earthquake, Stone Edge, Rock Polish, Dragon Dance, Superpower
Pupitar: Earthquake, Stone Edge, Rock Polish, Dragon Dance, Superpower
Tyranitar: Crunch, Stone Edge, Pursuit, Superpower, Fire Blast, Ice Beam, Stealth Rock, Aqua Tail, Dragon Dance
Lugia: Toxic, Dragon Tail, Roost, Substitute, Whirlwind, Ice Beam
Ho-Oh: Substitute, Sacred Fire, Brave Bird, Earthquake, Roost
Celebi: Nasty Plot, Psychic, Giga Drain, Recover, Heal Bell, Baton Pass, Stealth Rock, Earth Power, Hidden Power Fire, Hidden Power Ice, Calm Mind, Leaf Storm
Treecko: Substitute, Leech Seed, Giga Drain, Leaf Storm, Hidden Power Ice, Hidden Power Rock, Endeavor
Grovyle: Substitute, Leech Seed, Giga Drain, Leaf Storm, Hidden Power Ice, Hidden Power Rock, Endeavor
Sceptile: Substitute, Leech Seed, Giga Drain, Leaf Storm, Hidden Power Ice, Focus Blast, Synthesis, Hidden Power Rock
Torchic: Fire Blast, Protect, Baton Pass, Substitute, Hidden Power Grass
Combusken: Flare Blitz, Sky Uppercut, Protect, Swords Dance, Substitute, Baton Pass
Blaziken: Flare Blitz, Hi Jump Kick, Protect, Swords Dance, Substitute, Baton Pass, Brave Bird
Mudkip: Waterfall, Earth Power, Superpower, Ice Beam
Marshtomp: Waterfall, Earthquake, Superpower, Ice Punch, Rock Slide, Stealth Rock
Swampert: Waterfall, Earthquake, Ice Punch, Stealth Rock, Roar, Superpower, Stone Edge, Rest, Sleep Talk, Curse
Poochyena: Super Fang, Foul Play, Sucker Punch, Toxic
Mightyena: Sucker Punch, Crunch, Ice Fang, Fire Fang, Howl
Zigzagoon: Belly Drum, ExtremeSpeed, Seed Bomb, Substitute
Linoone: Belly Drum, ExtremeSpeed, Seed Bomb, Substitute, Shadow Claw
Wurmple: Bug Bite, Poison Sting, Tackle, Electroweb
Silcoon: Bug Bite, Poison Sting, Tackle, Electroweb
Beautifly: Quiver Dance, Bug Buzz, Giga Drain, Hidden Power Fighting, Hidden Power Rock, Substitute, Roost
Cascoon: Bug Bite, Poison Sting, Tackle, Electroweb
Dustox: Toxic, Roost, Whirlwind, Bug Buzz, Protect, Sludge Bomb, Quiver Dance
Lotad: Giga Drain, Ice Beam, Scald, Substitute, Leech Seed
Lombre: Giga Drain, Ice Beam, Scald, Substitute, Leech Seed
Ludicolo: Rain Dance, Hydro Pump, Surf, Giga Drain, Ice Beam, Scald, Leech Seed, Substitute, Toxic
Seedot: Leech Seed, Nature Power, Seed Bomb, Explosion, Foul Play
Nuzleaf: Foul Play, Nature Power, Seed Bomb, Explosion, Swords Dance
Shiftry: Hidden Power Fire, Swords Dance, Seed Bomb, Sucker Punch, Nature Power, Nasty Plot, Giga Drain, Dark Pulse
Taillow: Brave Bird, Facade, Quick Attack, U-turn, Protect
Swellow: Brave Bird, Facade, Quick Attack, U-turn, Protect
Wingull: Scald, Ice Beam, Hidden Power Grass, U-turn, Air Slash, Hurricane
Pelipper: Scald, Ice Beam, Hidden Power Grass, U-turn, Air Slash, Hurricane, Toxic, Roost
Ralts: Trick Room, Destiny Bond, Psychic, Will-O-Wisp
Kirlia: Trick Room, Destiny Bond, Psychic, Will-O-Wisp
Gardevoir: Psychic, Focus Blast, Shadow Ball, Trick, Calm Mind, Will-O-Wisp, Wish, Thunderbolt, Protect, Healing Wish
Gallade: Close Combat, Trick, Stone Edge, Shadow Sneak, Swords Dance, Bulk Up, Drain Punch, Ice Punch, Psycho Cut
Surskit: Hydro Pump, Signal Beam, Hidden Power Fire, Hidden Power Fighting, Giga Drain
Masquerain: Hydro Pump, Bug Buzz, Air Slash, Quiver Dance, Substitute, Baton Pass, Roost
Shroomish: Spore, Substitute, Leech Seed, Giga Drain, Protect, Toxic, Stun Spore
Breloom: Spore, Substitute, Leech Seed, Focus Punch, Mach Punch, Low Sweep, Bullet Seed, Stone Edge, Swords Dance, ThunderPunch
Slakoth: Return, Hammer Arm, Fire Punch, Sucker Punch, Giga Impact, Retaliate, Toxic
Vigoroth: Bulk Up, Return, Earthquake, Fire Punch, Sucker Punch, Slack Off
Slaking: Return, Earthquake, Pursuit, Fire Punch, Sucker Punch, Double-Edge, Retaliate, Giga Impact, Hammer Arm
Nincada: X-Scissor, Toxic, Aerial Ace, Night Slash
Ninjask: Baton Pass, Swords Dance, Substitute, Protect, X-Scissor
Shedinja: Swords Dance, Will-O-Wisp, X-Scissor, Shadow Sneak, Sucker Punch
Whismur: Hyper Voice, Fire Blast, Shadow Ball, Ice Beam
Loudred: Hyper Voice, Fire Blast, Shadow Ball, Ice Beam
Exploud: Hyper Voice, Overheat, Shadow Ball, Ice Beam, Surf, Focus Blast
Makuhita: Cross Chop, Bullet Punch, Close Combat, Ice Punch, Bulk Up
Hariyama: Cross Chop, Bullet Punch, Close Combat, Ice Punch, Stone Edge, Bulk Up
Nosepass: Stone Edge, Toxic, Stealth Rock, Thunder Wave
Probopass: Stealth Rock, Thunder Wave, Toxic, Earth Power, Power Gem, Volt Switch
Skitty: Return, Sucker Punch, Zen Headbutt, Thunder Wave, Fake Out
Delcatty: Return, Sucker Punch, Zen Headbutt, Thunder Wave, Fake Out, Wish
Sableye: Recover, Will-O-Wisp, Taunt, Trick, Toxic, Night Shade, Seismic Toss
Mawile: Swords Dance, Iron Head, Fire Fang, Crunch, Baton Pass, Substitute
Aron: Head Smash, Iron Head, Earthquake, Superpower, Stealth Rock
Lairon: Head Smash, Iron Head, Earthquake, Superpower, Stealth Rock
Aggron: Rock Polish, Head Smash, Earthquake, Superpower, Heavy Slam, Aqua Tail, Ice Punch, Stealth Rock, Thunder Wave
Meditite: Hi Jump Kick, Psycho Cut, Ice Punch, ThunderPunch, Trick, Fake Out, Bullet Punch, Drain Punch
Medicham: Hi Jump Kick, Drain Punch, Psycho Cut, Ice Punch, ThunderPunch, Trick, Fake Out, Bullet Punch
Electrike: Volt Switch, Thunderbolt, Hidden Power Ice, Overheat, Switcheroo, Flamethrower
Manectric: Volt Switch, Thunderbolt, Hidden Power Ice, Overheat, Switcheroo, Flamethrower
Plusle: Nasty Plot, Thunderbolt, Substitute, Baton Pass, Hidden Power Ice
Minun: Nasty Plot, Thunderbolt, Substitute, Baton Pass, Hidden Power Ice
Volbeat: Tail Glow, Baton Pass, Substitute, Bug Buzz, Thunder Wave, Encore
Illumise: Substitute, Baton Pass, Wish, Bug Buzz, Encore, Thunderbolt
Budew: Spikes, Toxic Spikes, Sleep Powder, Giga Drain, Stun Spore, Rest
Roselia: Spikes, Toxic Spikes, Sleep Powder, Giga Drain, Stun Spore, Rest
Roserade: Sludge Bomb, Giga Drain, Sleep Powder, Leaf Storm, Spikes, Toxic Spikes, Rest, Synthesis, Hidden Power Fire
Gulpin: Stockpile, Sludge Bomb, Ice Beam, Toxic, Pain Split, Yawn, Encore
Swalot: Stockpile, Sludge Bomb, Ice Beam, Toxic, Pain Split, Yawn, Encore, Earthquake
Carvanha: Protect, Hydro Pump, Ice Beam, Waterfall, Crunch, Hidden Power Grass, Aqua Jet
Sharpedo: Protect, Hydro Pump, Ice Beam, Crunch, Earthquake, Waterfall, Hidden Power Grass, Aqua Jet
Wailmer: Water Spout, Surf, Hydro Pump, Ice Beam, Hidden Power Grass, Hidden Power Electric
Wailord: Water Spout, Surf, Hydro Pump, Ice Beam, Hidden Power Grass, Hidden Power Electric
Numel: Curse, Earthquake, Rock Slide, Fire Blast, Flame Charge, Rest, Sleep Talk, Stockpile
Camerupt: Rock Polish, Fire Blast, Earth Power, Stone Edge, Lava Plume, Stealth Rock, Earthquake
Torkoal: Rapid Spin, Stealth Rock, Yawn, Lava Plume, Earthquake, Toxic, Will-O-Wisp
Spoink: Psychic, Reflect, Light Screen, Thunder Wave, Trick, Heal Bell
Grumpig: Calm Mind, Psychic, Focus Blast, Shadow Ball, Thunder Wave, Trick, Heal Bell
Spinda: Wish, Protect, Return, Superpower, Sucker Punch
Trapinch: Earthquake, Rock Slide, Crunch, Quick Attack, Superpower
Vibrava: Substitute, Earthquake, Outrage, Roost, U-turn, Superpower
Flygon: Earthquake, Outrage, Dragon Claw, U-turn, Roost, Substitute, Stone Edge, Fire Punch, Superpower
Cacnea: Swords Dance, Spikes, Sucker Punch, Seed Bomb, Drain Punch
Cacturne: Swords Dance, Spikes, Sucker Punch, Seed Bomb, Drain Punch
Swablu: Roost, Toxic, Cotton Guard, Return
Altaria: Dragon Dance, Outrage, Dragon Claw, Earthquake, Roost, Fire Blast
Zangoose: Swords Dance, Close Combat, Night Slash, Quick Attack, Facade
Seviper: Sludge Bomb, Flamethrower, Giga Drain, Switcheroo, Earthquake, Sucker Punch, Aqua Tail
Lunatone: Psychic, Earth Power, Stealth Rock, Rock Polish, Baton Pass, Calm Mind, Ice Beam, Hidden Power Rock, Moonlight
Solrock: Stealth Rock, Explosion, Stone Edge, Zen Headbutt, Earthquake, Baton Pass, Will-O-Wisp, Rock Polish, Morning Sun
Barboach: Dragon Dance, Waterfall, Earthquake, Return
Whiscash: Dragon Dance, Waterfall, Earthquake, Stone Edge
Corphish: Dragon Dance, Waterfall, Crunch, Superpower, Swords Dance
Crawdaunt: Dragon Dance, Waterfall, Crunch, Superpower, Swords Dance
Baltoy: Stealth Rock, Earthquake, Toxic, Psychic, Reflect, Light Screen, Ice Beam, Rapid Spin
Claydol: Stealth Rock, Toxic, Psychic, Ice Beam, Earthquake, Rapid Spin, Reflect, Light Screen
Lileep: Stealth Rock, Recover, AncientPower, Hidden Power Fire, Giga Drain, Stockpile
Cradily: Stealth Rock, Recover, Stockpile, Seed Bomb, Rock Slide, Earthquake, Curse, Swords Dance
Anorith: Stealth Rock, Brick Break, Toxic, X-Scissor, Rock Slide, Swords Dance, Rock Polish
Armaldo: Stealth Rock, Stone Edge, Toxic, X-Scissor, Swords Dance, Earthquake, Superpower
Feebas: Protect, Confuse Ray, Hypnosis, Scald, Toxic
Milotic: Recover, Scald, Hypnosis, Toxic, Ice Beam, Dragon Tail, Rest, Sleep Talk, Hidden Power Grass
Castform: Sunny Day, Rain Dance, Fire Blast, Hydro Pump, Thunder, Ice Beam, SolarBeam
Kecleon: Stealth Rock, Recover, Return, Thunder Wave, Sucker Punch
Shuppet: Trick Room, Destiny Bond, Taunt, Shadow Sneak, Will-O-Wisp
Banette: Trick Room, Destiny Bond, Taunt, Shadow Claw, Will-O-Wisp
Duskull: Will-O-Wisp, Shadow Sneak, Ice Beam, Pain Split, Substitute, Night Shade
Dusclops: Will-O-Wisp, Shadow Sneak, Ice Beam, Pain Split, Substitute, Seismic Toss
Dusknoir: Will-O-Wisp, Shadow Sneak, Ice Beam, Pain Split, Substitute, Earthquake, Focus Punch
Tropius: Leech Seed, Substitute, Air Slash, Giga Drain, Earthquake, Hidden Power Fire, Roost, Leaf Storm
Chingling: Hypnosis, Reflect, Light Screen, Toxic, Wish, Psychic
Chimecho: Hypnosis, Toxic, Wish, Psychic, Thunder Wave, Recover, Calm Mind, Shadow Ball, Hidden Power Fighting, Healing Wish
Absol: Swords Dance, Sucker Punch, Night Slash, Psycho Cut, Superpower, Pursuit, Megahorn
Snorunt: Spikes, Ice Beam, Hidden Power Ground, Ice Shard, Crunch
Glalie: Spikes, Ice Beam, Ice Shard, Crunch, Earthquake
Froslass: Ice Beam, Spikes, Destiny Bond, Shadow Ball, Substitute, Thunderbolt, Thunder Wave
Spheal: Substitute, Protect, Toxic, Surf, Ice Beam
Sealeo: Substitute, Protect, Toxic, Surf, Ice Beam
Walrein: Substitute, Protect, Toxic, Surf, Ice Beam, Roar
Clamperl: Shell Smash, Ice Beam, Surf, Hidden Power Grass, Hidden Power Electric, Substitute
Huntail: Shell Smash, Return, Hydro Pump, Baton Pass, Sucker Punch
Gorebyss: Shell Smash, Baton Pass, Hydro Pump, Ice Beam, Hidden Power Grass, Substitute
Relicanth: Head Smash, Waterfall, Earthquake, Double-Edge, Stealth Rock
Luvdisc: Surf, Ice Beam, Toxic, Sweet Kiss, Protect
Bagon: Outrage, Dragon Dance, Fire Fang, Rock Slide, Dragon Claw
Shelgon: Outrage, Brick Break, Dragon Claw, Dragon Dance
Salamence: Outrage, Fire Blast, Earthquake, Draco Meteor, Roost, Dragon Dance, Dragon Claw
Beldum: Iron Head, Zen Headbutt, Headbutt, Iron Defense
Metang: Stealth Rock, Meteor Mash, Toxic, Earthquake, Bullet Punch
Metagross: Meteor Mash, Earthquake, Agility, Stealth Rock, Zen Headbutt, Bullet Punch, Trick
Regirock: Stealth Rock, Thunder Wave, Stone Edge, Earthquake, Curse, Rest, Sleep Talk, Rock Slide, Toxic
Regice: Thunder Wave, Ice Beam, Thunderbolt, Rest, Sleep Talk, Focus Blast
Registeel: Stealth Rock, Iron Head, Curse, Rest, Thunder Wave, Toxic
Latias: Dragon Pulse, Surf, Hidden Power Fire, Roost, Calm Mind, Healing Wish
Latios: Draco Meteor, Dragon Pulse, Surf, Hidden Power Fire, Psyshock, Roost
Kyogre: Water Spout, Surf, Thunder, Ice Beam, Calm Mind, Rest, Sleep Talk
Groudon: Earthquake, Dragon Tail, Stealth Rock, Stone Edge, Swords Dance, Rock Polish, Thunder Wave, Fire Punch
Rayquaza: Outrage, V-create, ExtremeSpeed, Dragon Dance, Swords Dance, Draco Meteor, Dragon Claw
Jirachi: Iron Head, Fire Punch, Thunder Wave, Stealth Rock, Wish, U-turn, Calm Mind, Psychic, Thunder, Ice Punch, Flash Cannon
Deoxys: Psycho Boost, Superpower, ExtremeSpeed, Ice Beam, Thunderbolt, Fire Punch, Spikes, Stealth Rock
Deoxys-Attack: Psycho Boost, Superpower, ExtremeSpeed, Ice Beam, Thunderbolt, Fire Punch, Spikes, Stealth Rock
Deoxys-Defense: Spikes, Stealth Rock, Recover, Taunt, Toxic, Agility, Seismic Toss, Magic Coat
Deoxys-Speed: Spikes, Stealth Rock, Superpower, Ice Beam, Psycho Boost, Taunt, Light Screen, Reflect, Magic Coat, Trick
Turtwig: Reflect, Light Screen, Stealth Rock, Seed Bomb, Substitute, Leech Seed, Toxic
Grotle: Reflect, Light Screen, Stealth Rock, Seed Bomb, Substitute, Leech Seed, Toxic
Torterra: Stealth Rock, Earthquake, Wood Hammer, Stone Edge, Synthesis, Leech Seed
Chimchar: Stealth Rock, Overheat, Hidden Power Grass, Fake Out
Monferno: Stealth Rock, Overheat, Hidden Power Grass, Fake Out, Vacuum Wave
Infernape: Stealth Rock, Fire Blast, Close Combat, U-turn, Grass Knot, Stone Edge, Mach Punch, Swords Dance, Nasty Plot, Flare Blitz, Hidden Power Ice, ThunderPunch
Piplup: Stealth Rock, Hydro Pump, Scald, Ice Beam, Hidden Power Electric, Hidden Power Fire, Yawn
Prinplup: Stealth Rock, Hydro Pump, Scald, Ice Beam, Hidden Power Electric, Hidden Power Fire, Yawn
Empoleon: Stealth Rock, Hydro Pump, Scald, Ice Beam, Hidden Power Electric, Hidden Power Fire, Roar, Grass Knot
Starly: Brave Bird, Return, U-turn, Pursuit
Staravia: Brave Bird, Return, U-turn, Pursuit
Staraptor: Brave Bird, Close Combat, Return, U-turn, Quick Attack, Substitute, Roost, Double-Edge
Bidoof: Return, Aqua Tail, Curse, Quick Attack, Stealth Rock
Bibarel: Return, Waterfall, Curse, Quick Attack, Stealth Rock
Kricketot: Endeavor, Mud-Slap, Bug Bite, Struggle Bug
Kricketune: Swords Dance, Bug Bite, Aerial Ace, Brick Break, Toxic
Shinx: Wild Charge, Ice Fang, Fire Fang, Crunch
Luxio: Wild Charge, Ice Fang, Fire Fang, Crunch
Luxray: Wild Charge, Ice Fang, Fire Fang, Crunch, Superpower
Cranidos: Head Smash, Rock Slide, Earthquake, Zen Headbutt, Fire Punch, Rock Polish, Crunch
Rampardos: Head Smash, Rock Slide, Earthquake, Zen Headbutt, Fire Punch, Rock Polish, Crunch
Shieldon: Stealth Rock, Metal Burst, Fire Blast, Ice Beam, Protect, Toxic, Roar
Bastiodon: Stealth Rock, Metal Burst, Fire Blast, Ice Beam, Protect, Toxic, Roar
Burmy: Bug Bite, Hidden Power Ice, Electroweb, Protect
Burmy-Sandy: Bug Bite, Hidden Power Ice, Electroweb, Protect
Burmy-Trash: Bug Bite, Hidden Power Ice, Electroweb, Protect
Wormadam: Leaf Storm, Giga Drain, Signal Beam, Hidden Power Ice, Hidden Power Rock, Toxic, Psychic, Protect
Wormadam-Sandy: Earthquake, Toxic, Bug Bite, Protect, Sucker Punch
Wormadam-Trash: Stealth Rock, Toxic, Iron Head, Protect
Mothim: Quiver Dance, Bug Buzz, Air Slash, Giga Drain, Roost
Combee: Bug Buzz, Air Cutter, Endeavor, Ominous Wind
Vespiquen: Substitute, Roost, Toxic, Attack Order, Protect, Defend Order
Pachirisu: Light Screen, Discharge, Super Fang, Toxic, Volt Switch
Buizel: Waterfall, Return, Aqua Jet, Switcheroo, Brick Break, Bulk Up, Baton Pass, Ice Punch
Floatzel: Waterfall, Return, Aqua Jet, Switcheroo, Brick Break, Bulk Up, Baton Pass, Ice Punch, Crunch
Cherubi: Sunny Day, SolarBeam, Weather Ball, Hidden Power Ice
Cherrim: Sunny Day, SolarBeam, Weather Ball, Hidden Power Ice
Shellos: Scald, Clear Smog, Recover, Toxic, Ice Beam
Shellos-East: Scald, Clear Smog, Recover, Toxic, Ice Beam
Gastrodon: Earth Power, Ice Beam, Scald, Toxic, Recover, Clear Smog
Gastrodon-East: Earth Power, Ice Beam, Scald, Toxic, Recover, Clear Smog
Drifloon: Acrobatics, Shadow Ball, Substitute, Calm Mind, Hypnosis, Hidden Power Fighting, Thunderbolt, Destiny Bond, Will-O-Wisp, Stockpile, Baton Pass
Drifblim: Acrobatics, Shadow Ball, Substitute, Calm Mind, Hypnosis, Hidden Power Fighting, Thunderbolt, Destiny Bond, Will-O-Wisp, Stockpile, Baton Pass
Buneary: Fake Out, Return, Switcheroo, ThunderPunch, Jump Kick, Quick Attack, Fire Punch, Circle Throw, Ice Punch, Healing Wish
Lopunny: Fake Out, Return, Switcheroo, ThunderPunch, Jump Kick, Quick Attack, Fire Punch, Circle Throw, Ice Punch, Healing Wish
Glameow: Fake Out, U-turn, Sucker Punch, Hypnosis, Quick Attack, Return, Foul Play
Purugly: Fake Out, U-turn, Sucker Punch, Hypnosis, Quick Attack, Return
Stunky: Pursuit, Sucker Punch, Crunch, Fire Blast, Explosion, Taunt
Skuntank: Pursuit, Sucker Punch, Crunch, Fire Blast, Explosion, Taunt, Poison Jab
Bronzor: Stealth Rock, Psychic, Toxic, Hypnosis, Reflect, Light Screen, Trick Room, Explosion
Bronzong: Stealth Rock, Psychic, Earthquake, Toxic, Hypnosis, Reflect, Light Screen, Trick Room, Explosion
Chatot: Nasty Plot, Hyper Voice, Heat Wave, Hidden Power Grass, Substitute, Chatter
Spiritomb: Shadow Sneak, Sucker Punch, Pursuit, Trick, Will-O-Wisp, Calm Mind, Dark Pulse, Rest, Sleep Talk
Gible: Outrage, Dragon Claw, Earthquake, Fire Blast, Stone Edge, Stealth Rock
Gabite: Outrage, Dragon Claw, Earthquake, Fire Blast, Stone Edge, Stealth Rock
Garchomp: Outrage, Dragon Claw, Earthquake, Stone Edge, Fire Fang, Swords Dance
Riolu: Crunch, Roar, Copycat, Drain Punch
Lucario: Swords Dance, Close Combat, Crunch, ExtremeSpeed, Ice Punch, Bullet Punch, Nasty Plot, Aura Sphere, Dark Pulse, Vacuum Wave
Hippopotas: Earthquake, Slack Off, Whirlwind, Stealth Rock, Protect, Toxic
Hippowdon: Earthquake, Slack Off, Whirlwind, Stealth Rock, Protect, Toxic, Ice Fang, Stone Edge, Stockpile
Skorupi: Toxic Spikes, X-Scissor, Poison Jab, Protect
Drapion: Crunch, Whirlwind, Toxic Spikes, Pursuit, Earthquake, Aqua Tail, Swords Dance, Poison Jab, Rest, Sleep Talk
Croagunk: Fake Out, Vacuum Wave, Sucker Punch, Drain Punch, Dark Pulse
Toxicroak: Fake Out, Sucker Punch, Drain Punch, Bulk Up, Substitute, Swords Dance, Cross Chop, Ice Punch
Carnivine: Swords Dance, Power Whip, Return, Sleep Powder, Substitute, Leech Seed
Finneon: Surf, U-turn, Ice Beam, Hidden Power Electric, Hidden Power Grass, Rain Dance
Lumineon: Surf, U-turn, Ice Beam, Hidden Power Electric, Hidden Power Grass, Rain Dance
Snover: Blizzard, Ice Shard, Giga Drain, Leech Seed, Substitute
Abomasnow: Blizzard, Ice Shard, Giga Drain, Leech Seed, Substitute, Focus Blast
Rotom: Thunderbolt, Discharge, Volt Switch, Shadow Ball, Substitute, Pain Split, Hidden Power Ice, Hidden Power Fighting, Will-O-Wisp, Rest, Sleep Talk, Trick
Rotom-Heat: Thunderbolt, Discharge, Volt Switch, Substitute, Pain Split, Hidden Power Ice, Will-O-Wisp, Rest, Sleep Talk, Overheat, Trick
Rotom-Wash: Thunderbolt, Discharge, Volt Switch, Substitute, Pain Split, Hidden Power Ice, Will-O-Wisp, Rest, Sleep Talk, Trick, Hydro Pump
Rotom-Frost: Thunderbolt, Discharge, Volt Switch, Substitute, Pain Split, Hidden Power Fighting, Will-O-Wisp, Rest, Sleep Talk, Trick, Blizzard
Rotom-Fan: Thunderbolt, Discharge, Volt Switch, Thunder Wave, Substitute, Pain Split, Hidden Power Fighting, Will-O-Wisp, Rest, Sleep Talk, Trick, Air Slash, Confuse Ray
Rotom-Mow: Thunderbolt, Discharge, Volt Switch, Substitute, Pain Split, Hidden Power Ice, Will-O-Wisp, Rest, Sleep Talk, Trick, Leaf Storm
Uxie: Reflect, Light Screen, U-turn, Psychic, Thunder Wave, Yawn, Heal Bell, Stealth Rock, Trick, Toxic
Mesprit: Calm Mind, Psychic, Thunderbolt, Ice Beam, Substitute, U-turn, Trick, Stealth Rock
Azelf: Nasty Plot, Psychic, Fire Blast, Grass Knot, Thunderbolt, Ice Punch, U-turn, Trick, Taunt, Stealth Rock, Explosion
Dialga: Stealth Rock, Draco Meteor, Dragon Pulse, Roar, Dragon Tail, Thunderbolt, Outrage, Bulk Up, Fire Blast, Aura Sphere, Rest, Sleep Talk, Dragon Claw
Palkia: Spacial Rend, Draco Meteor, Surf, Hydro Pump, Thunderbolt, Outrage, Fire Blast
Heatran: Substitute, Fire Blast, Lava Plume, Will-O-Wisp, Stealth Rock, Earth Power, Hidden Power Grass, Hidden Power Ice, Protect, Toxic, Roar
Regigigas: Thunder Wave, Substitute, Return, Drain Punch, Earthquake, Fire Punch, Toxic, Confuse Ray
Giratina: Rest, Sleep Talk, Dragon Tail, Roar, Will-O-Wisp, Calm Mind, Dragon Pulse, Shadow Ball
Giratina-Origin: Draco Meteor, Shadow Sneak, Dragon Tail, Hidden Power Fire, Will-O-Wisp, Calm Mind, Substitute, Dragon Pulse, Shadow Ball, Aura Sphere, Outrage
Cresselia: Moonlight, Psychic, Ice Beam, Thunder Wave, Toxic, Lunar Dance, Rest, Sleep Talk, Calm Mind, Reflect, Light Screen
Phione: Rain Dance, Scald, U-turn, Rest, Ice Beam, Surf
Manaphy: Tail Glow, Surf, Ice Beam, Grass Knot
Darkrai: Dark Void, Dark Pulse, Focus Blast, Nasty Plot, Substitute, Trick
Shaymin: Seed Flare, Earth Power, Air Slash, Hidden Power Fire, Rest, Substitute, Leech Seed
Shaymin-Sky: Seed Flare, Earth Power, Air Slash, Hidden Power Ice, Hidden Power Fire, Substitute, Leech Seed
Arceus: Swords Dance, ExtremeSpeed, Shadow Claw, Earthquake, Recover
Arceus-Bug: Swords Dance, X-Scissor, Stone Edge, Recover, Calm Mind, Judgment, Ice Beam, Fire Blast
Arceus-Dark: Calm Mind, Judgment, Recover, Refresh
Arceus-Dragon: Swords Dance, Outrage, ExtremeSpeed, Earthquake, Recover
Arceus-Electric: Calm Mind, Judgment, Recover, Ice Beam
Arceus-Fighting: Calm Mind, Judgment, Ice Beam, Dark Pulse, Recover, Toxic
Arceus-Fire: Calm Mind, Flamethrower, Fire Blast, Thunderbolt, Recover
Arceus-Flying: Calm Mind, Judgment, Refresh, Recover
Arceus-Ghost: Calm Mind, Judgment, Focus Blast, Flamethrower, Recover, Swords Dance, Shadow Claw, Brick Break, Will-O-Wisp, Roar
Arceus-Grass: Calm Mind, Ice Beam, Judgment, Earth Power, Recover, Stealth Rock, Thunder Wave
Arceus-Ground: Swords Dance, Earthquake, Stone Edge, Recover, Calm Mind, Judgment, Ice Beam, Stealth Rock
Arceus-Ice: Calm Mind, Judgment, Ice Beam, Thunderbolt, Focus Blast, Recover
Arceus-Poison: Calm Mind, Judgment, Sludge Bomb, Focus Blast, Fire Blast, Recover, Will-O-Wisp, Ice Beam, Stealth Rock
Arceus-Psychic: Calm Mind, Psyshock, Focus Blast, Recover, Will-O-Wisp, Judgment
Arceus-Rock: Calm Mind, Judgment, Recover, Will-O-Wisp, Swords Dance, Stone Edge, Earthquake, Refresh
Arceus-Steel: Calm Mind, Judgment, Recover, Roar, Will-O-Wisp, Swords Dance, Iron Head
Arceus-Water: Swords Dance, Waterfall, ExtremeSpeed, Dragon Claw, Recover, Calm Mind, Judgment, Ice Beam, Fire Blast
Victini: V-create, Fusion Bolt, U-turn, Psychic, Energy Ball, Focus Blast, Fire Blast, Thunder
Snivy: Leaf Storm, Hidden Power Fire, Substitute, Leech Seed, Hidden Power Ice, Giga Drain
Servine: Leaf Storm, Hidden Power Fire, Substitute, Leech Seed, Hidden Power Ice, Giga Drain
Serperior: Leaf Storm, Hidden Power Fire, Substitute, Leech Seed, Dragon Pulse, Giga Drain
Tepig: Flame Charge, Flare Blitz, Wild Charge, Superpower, Head Smash
Pignite: Flame Charge, Flare Blitz, Wild Charge, Superpower, Head Smash
Emboar: Flare Blitz, Superpower, Flame Charge, Wild Charge, Head Smash, Earthquake, Fire Blast
Oshawott: Swords Dance, Waterfall, Aqua Jet, X-Scissor
Dewott: Swords Dance, Waterfall, Aqua Jet, X-Scissor
Samurott: Swords Dance, Aqua Jet, Waterfall, Megahorn, Superpower
Patrat: Swords Dance, Baton Pass, Substitute, Hypnosis, Return, Super Fang
Watchog: Swords Dance, Baton Pass, Substitute, Hypnosis, Return, Super Fang
Lillipup: Return, Wild Charge, Fire Fang, Crunch, Ice Fang
Herdier: Return, Wild Charge, Fire Fang, Crunch, Ice Fang
Stoutland: Return, Wild Charge, Superpower, Crunch, Ice Fang
Purrloin: Swagger, Thunder Wave, Substitute, Foul Play
Liepard: Swagger, Thunder Wave, Substitute, Foul Play
Pansage: Leaf Storm, Hidden Power Fire, Hidden Power Ice, Giga Drain, Nasty Plot, Substitute, Leech Seed
Simisage: Nasty Plot, Leaf Storm, Hidden Power Fire, Hidden Power Ice, Giga Drain, Focus Blast, Substitute, Leech Seed, Synthesis
Pansear: Nasty Plot, Fire Blast, Hidden Power Electric, Hidden Power Ground, Sunny Day, SolarBeam, Overheat
Simisear: Nasty Plot, Fire Blast, Focus Blast, Grass Knot, Hidden Power Ground, Substitute, Flamethrower, Overheat
Panpour: Nasty Plot, Hydro Pump, Hidden Power Grass, Substitute, Surf
Simipour: Nasty Plot, Hydro Pump, Ice Beam, Substitute, Grass Knot, Surf
Munna: Psychic, Hidden Power Fighting, Hypnosis, Calm Mind, Moonlight, Shadow Ball, Thunder Wave, Baton Pass, Reflect, Light Screen, Trick, Heal Bell, Signal Beam
Musharna: Calm Mind, Thunder Wave, Moonlight, Psychic, Trick Room, Shadow Ball, Hidden Power Fighting, Baton Pass, Reflect, Light Screen, Trick, Heal Bell, Signal Beam
Pidove: Pluck, U-turn, Return, Detect, Roost, Wish
Tranquill: Pluck, U-turn, Return, Detect, Roost, Wish
Unfezant: Pluck, U-turn, Return, Detect, Roost, Wish
Blitzle: Volt Switch, Hidden Power Grass, Wild Charge, Me First
Zebstrika: Volt Switch, Hidden Power Grass, Overheat, Wild Charge
Roggenrola: Autotomize, Stone Edge, Stealth Rock, Rock Blast, Earthquake, Explosion
Boldore: Autotomize, Stone Edge, Stealth Rock, Rock Blast, Earthquake, Explosion
Gigalith: Stealth Rock, Rock Blast, Earthquake, Explosion, Stone Edge, Autotomize, Superpower
Woobat: Calm Mind, Psychic, Air Slash, Giga Drain, Roost, Heat Wave, Stored Power
Swoobat: Calm Mind, Psychic, Air Slash, Giga Drain, Roost, Heat Wave, Stored Power
Drilbur: Swords Dance, Rapid Spin, Earthquake, Rock Slide, Shadow Claw, Return, X-Scissor
Excadrill: Swords Dance, Rapid Spin, Earthquake, Rock Slide, Iron Head
Audino: Wish, Protect, Heal Bell, Toxic, Thunder Wave, Reflect, Light Screen, Return
Timburr: Mach Punch, Bulk Up, Drain Punch, Ice Punch
Gurdurr: Bulk Up, Mach Punch, Drain Punch, Ice Punch
Conkeldurr: Bulk Up, Mach Punch, Drain Punch, Ice Punch
Tympole: Hydro Pump, Surf, Sludge Wave, Earth Power, Hidden Power Electric
Palpitoad: Hydro Pump, Surf, Sludge Wave, Earth Power, Hidden Power Electric, Stealth Rock
Seismitoad: Hydro Pump, Surf, Sludge Wave, Earth Power, Hidden Power Electric, Stealth Rock
Throh: Bulk Up, Circle Throw, Ice Punch, Storm Throw, Rest, Sleep Talk
Sawk: Close Combat, Earthquake, Ice Punch, Stone Edge, Bulk Up
Sewaddle: Calm Mind, Giga Drain, Bug Buzz, Hidden Power Fire, Hidden Power Ice, Air Slash
Swadloon: Calm Mind, Giga Drain, Bug Buzz, Hidden Power Fire, Hidden Power Ice, Air Slash
Leavanny: Swords Dance, Leaf Blade, X-Scissor, Baton Pass
Venipede: Toxic Spikes, Steamroller, Spikes, Poison Jab
Whirlipede: Toxic Spikes, Steamroller, Spikes, Poison Jab
Scolipede: Spikes, Toxic Spikes, Megahorn, Rock Slide, Earthquake, Swords Dance, Baton Pass, Aqua Tail, Superpower
Cottonee: Encore, Taunt, Substitute, Leech Seed, Toxic, Stun Spore
Whimsicott: Encore, Taunt, Substitute, Leech Seed, U-turn, Toxic, Stun Spore
Petilil: Sunny Day, Sleep Powder, SolarBeam, Hidden Power Fire, Hidden Power Ice, Healing Wish
Lilligant: Quiver Dance, Giga Drain, Sleep Powder, Hidden Power Ice, Hidden Power Fire, Hidden Power Rock, Petal Dance
Basculin: Waterfall, Aqua Jet, Superpower, Crunch
Basculin-Blue-Striped: Waterfall, Aqua Jet, Superpower, Crunch
Sandile: Earthquake, Stone Edge, Pursuit, Crunch
Krokorok: Earthquake, Stone Edge, Pursuit, Crunch
Krookodile: Earthquake, Stone Edge, Pursuit, Crunch, Bulk Up, Superpower
Darumaka: U-turn, Flare Blitz, Fire Punch, Rock Slide, Superpower
Darmanitan: U-turn, Flare Blitz, Fire Punch, Rock Slide, Earthquake, Superpower
Maractus: Spikes, Giga Drain, Leech Seed, Hidden Power Fire, Toxic
Dwebble: Stealth Rock, Spikes, Shell Smash, Earthquake, Rock Blast, X-Scissor, Stone Edge
Crustle: Stealth Rock, Spikes, Shell Smash, Earthquake, Rock Blast, X-Scissor, Stone Edge
Scraggy: Dragon Dance, Ice Punch, Hi Jump Kick, Drain Punch, Rest, Bulk Up, Crunch
Scrafty: Dragon Dance, Ice Punch, Hi Jump Kick, Drain Punch, Rest, Bulk Up, Crunch
Sigilyph: Cosmic Power, Roost, Stored Power, Psycho Shift
Yamask: Nasty Plot, Trick Room, Shadow Ball, Hidden Power Fighting, Will-O-Wisp, Haze, Rest, Sleep Talk, Pain Split
Cofagrigus: Nasty Plot, Trick Room, Shadow Ball, Hidden Power Fighting, Will-O-Wisp, Haze, Rest, Sleep Talk, Pain Split
Tirtouga: Shell Smash, Aqua Jet, Waterfall, Stone Edge, Earthquake, Stealth Rock
Carracosta: Shell Smash, Aqua Jet, Waterfall, Stone Edge, Earthquake, Stealth Rock
Archen: Acrobatics, Stone Edge, Rock Slide, Earthquake, U-turn, Pluck, Head Smash
Archeops: Acrobatics, Stone Edge, Rock Slide, Earthquake, U-turn, Pluck, Head Smash
Trubbish: Clear Smog, Toxic Spikes, Spikes, Gunk Shot
Garbodor: Spikes, Toxic Spikes, Gunk Shot, Clear Smog
Zorua: Sucker Punch, Extrasensory, Dark Pulse, Hidden Power Fighting, U-turn
Zoroark: Sucker Punch, Dark Pulse, Focus Blast, Flamethrower, U-turn, Nasty Plot
Minccino: Return, Tail Slap, Wake-Up Slap, U-turn, Aqua Tail
Cinccino: Return, Tail Slap, Wake-Up Slap, U-turn, Aqua Tail, Bullet Seed, Rock Blast
Gothita: Psychic, Thunderbolt, Hidden Power Fighting, Shadow Ball, Substitute, Calm Mind, Reflect, Light Screen, Trick
Gothorita: Psychic, Thunderbolt, Hidden Power Fighting, Shadow Ball, Substitute, Calm Mind, Reflect, Light Screen, Trick
Gothitelle: Psychic, Thunderbolt, Hidden Power Fighting, Shadow Ball, Substitute, Calm Mind, Reflect, Light Screen, Trick
Solosis: Calm Mind, Recover, Psychic, Hidden Power Fighting, Shadow Ball, Trick Room, Psyshock
Duosion: Calm Mind, Recover, Psychic, Hidden Power Fighting, Shadow Ball, Trick Room, Psyshock
Reuniclus: Calm Mind, Recover, Psychic, Focus Blast, Shadow Ball, Trick Room, Psyshock
Ducklett: Scald, Air Slash, Roost, Hurricane, Ice Beam, Hidden Power Grass, Brave Bird
Swanna: Air Slash, Roost, Hurricane, Surf, Ice Beam, Rain Dance
Vanillite: Ice Beam, Flash Cannon, Hidden Power Grass, Hidden Power Fighting, Autotomize
Vanillish: Ice Beam, Flash Cannon, Hidden Power Grass, Hidden Power Fighting, Autotomize
Vanilluxe: Ice Beam, Flash Cannon, Hidden Power Grass, Hidden Power Fighting, Autotomize
Deerling: Work Up, Agility, Baton Pass, Substitute, Jump Kick, Nature Power, Synthesis, Return
Sawsbuck: Swords Dance, Horn Leech, Jump Kick, Nature Power, Return, Substitute, Synthesis, Baton Pass
Emolga: Agility, Charge Beam, Baton Pass, Substitute, Thunderbolt, Air Slash, Roost
Karrablast: Swords Dance, Megahorn, Return, Substitute
Escavalier: Megahorn, Pursuit, Iron Head, Knock Off, Return, Swords Dance
Foongus: Spore, Stun Spore, Giga Drain, Clear Smog, Hidden Power Fire, Synthesis
Amoonguss: Spore, Stun Spore, Giga Drain, Clear Smog, Hidden Power Fire, Synthesis
Frillish: Scald, Will-O-Wisp, Recover, Toxic, Shadow Ball
Jellicent: Scald, Will-O-Wisp, Recover, Toxic, Shadow Ball, Ice Beam, Giga Drain
Alomomola: Wish, Protect, Waterfall, Toxic, Scald
Joltik: Thunderbolt, Bug Buzz, Hidden Power Ice, Giga Drain, Volt Switch
Galvantula: Thunder, Hidden Power Ice, Giga Drain, Bug Buzz, Volt Switch
Ferroseed: Spikes, Stealth Rock, Leech Seed, Seed Bomb, Protect, Thunder Wave
Ferrothorn: Spikes, Stealth Rock, Leech Seed, Power Whip, Thunder Wave, Protect
Klink: Shift Gear, Return, Gear Grind, Wild Charge
Klang: Shift Gear, Return, Gear Grind, Wild Charge
Klinklang: Shift Gear, Return, Gear Grind, Wild Charge
Tynamo: Spark, Charge Beam, Thunder Wave, Tackle
Eelektrik: U-turn, Volt Switch, Acid Spray, Wild Charge, Hidden Power Ice, Discharge, Giga Drain, Aqua Tail, Coil
Eelektross: Thunderbolt, Flamethrower, Grass Knot, U-turn, Volt Switch, Acid Spray, Wild Charge, Hidden Power Ice, Discharge, Superpower, ThunderPunch, Giga Drain, Aqua Tail, Coil
Elgyem: Nasty Plot, Psychic, Thunderbolt, Hidden Power Fighting, Substitute, Calm Mind, Recover, Trick
Beheeyem: Nasty Plot, Psychic, Thunderbolt, Hidden Power Fighting, Substitute, Calm Mind, Recover, Trick
Litwick: Calm Mind, Shadow Ball, Energy Ball, Fire Blast, Overheat, Hidden Power Fighting, Hidden Power Ground, Hidden Power Rock, Trick
Lampent: Calm Mind, Shadow Ball, Energy Ball, Fire Blast, Overheat, Hidden Power Fighting, Hidden Power Ground, Hidden Power Rock, Trick
Chandelure: Calm Mind, Shadow Ball, Energy Ball, Fire Blast, Overheat, Hidden Power Fighting, Hidden Power Ground, Hidden Power Rock, Trick
Axew: Dragon Dance, Outrage, Dragon Claw, Swords Dance, Aqua Tail, Superpower
Fraxure: Dragon Dance, Swords Dance, Outrage, Dragon Claw, Aqua Tail, Superpower
Haxorus: Dragon Dance, Swords Dance, Outrage, Dragon Claw, Earthquake, Aqua Tail, Superpower
Cubchoo: Ice Beam, Surf, Hidden Power Grass, Superpower
Beartic: Icicle Crash, Superpower, Night Slash, Stone Edge, Swords Dance, Aqua Jet
Cryogonal: Ice Beam, Recover, Toxic, Rapid Spin, Reflect
Shelmet: Spikes, Yawn, Substitute, Acid Armor, Baton Pass, Recover, Toxic, Bug Buzz
Accelgor: Spikes, Yawn, Bug Buzz, Focus Blast, Giga Drain, Hidden Power Rock, Encore
Stunfisk: Discharge, Thunderbolt, Earth Power, Scald, Toxic, Rest, Sleep Talk, Hidden Power Ice, Stealth Rock
Mienfoo: U-turn, Drain Punch, Stone Edge, Swords Dance, Baton Pass, Hi Jump Kick, Fake Out
Mienshao: U-turn, Fake Out, Hi Jump Kick, Stone Edge, Drain Punch, Swords Dance, Baton Pass
Druddigon: Outrage, Superpower, Earthquake, Sucker Punch, Dragon Claw, Dragon Tail, Substitute, Glare, Stealth Rock, Fire Punch, ThunderPunch
Golett: Earthquake, Shadow Punch, DynamicPunch, Ice Punch, Stone Edge, Stealth Rock
Golurk: Earthquake, Shadow Punch, DynamicPunch, Ice Punch, Stone Edge, Stealth Rock
Pawniard: Swords Dance, Substitute, Sucker Punch, Iron Head, Brick Break, Night Slash
Bisharp: Swords Dance, Substitute, Sucker Punch, Iron Head, Brick Break, Night Slash
Bouffalant: Head Charge, Earthquake, Stone Edge, Megahorn, Swords Dance, Superpower
Rufflet: Brave Bird, Rock Slide, Return, U-turn, Substitute, Bulk Up, Roost
Braviary: Brave Bird, Superpower, Return, U-turn, Substitute, Rock Slide, Bulk Up, Roost
Vullaby: Knock Off, Roost, Taunt, Whirlwind, Toxic, Dark Pulse, U-turn, Brave Bird
Mandibuzz: Knock Off, Roost, Taunt, Whirlwind, Toxic, U-turn, Brave Bird, Dark Pulse
Heatmor: Fire Blast, Sucker Punch, Focus Blast, Giga Drain
Durant: Hone Claws, Iron Head, X-Scissor, Stone Edge, Baton Pass, Superpower
Deino: Outrage, Crunch, Fire Fang, Dragon Tail, Thunder Wave, Superpower
Zweilous: Outrage, Crunch, Fire Fang, Dragon Tail, Thunder Wave, Superpower
Hydreigon: U-turn, Draco Meteor, Substitute, Dragon Pulse, Focus Blast, Fire Blast, Surf, Dark Pulse, Roost
Larvesta: Flare Blitz, U-turn, Wild Charge, Zen Headbutt, Morning Sun, Will-O-Wisp
Volcarona: Quiver Dance, Fiery Dance, Fire Blast, Bug Buzz, Roost, Hidden Power Rock, Giga Drain
Cobalion: Close Combat, Iron Head, Swords Dance, Substitute, Stone Edge, Volt Switch, Hidden Power Ice, Thunder Wave, Stealth Rock
Terrakion: Stone Edge, Close Combat, Swords Dance, Rock Polish, Substitute, Earthquake
Virizion: Swords Dance, Calm Mind, Close Combat, Focus Blast, Hidden Power Ice, Stone Edge, Leaf Blade, Giga Drain, Substitute, Synthesis
Tornadus: Hurricane, Air Slash, U-turn, Bulk Up, Acrobatics, Superpower, Focus Blast, Taunt, Substitute, Heat Wave
Tornadus-Therian: Hurricane, Air Slash, Focus Blast, U-turn, Heat Wave
Thundurus: Thunder Wave, Nasty Plot, Thunderbolt, Hidden Power Ice, Focus Blast, Grass Knot, Substitute
Thundurus-Therian: Nasty Plot, Agility, Thunderbolt, Hidden Power Ice, Focus Blast, Grass Knot
Reshiram: Blue Flare, Draco Meteor, Dragon Pulse, Flamethrower, Flame Charge, Roost
Zekrom: Volt Switch, Outrage, Dragon Claw, Bolt Strike, Hone Claws, Substitute, Draco Meteor, Fusion Bolt, Roost
Landorus: Earth Power, Focus Blast, Rock Polish, Hidden Power Ice, Psychic
Landorus-Therian: Rock Polish, Earthquake, Stone Edge, U-turn, Superpower, Stealth Rock
Kyurem: Substitute, Ice Beam, Draco Meteor, Dragon Pulse, Focus Blast, Outrage, Earth Power, Roost
Kyurem-Black: Outrage, Fusion Bolt, Ice Beam, Roost
Kyurem-White: Draco Meteor, Dragon Pulse, Ice Beam, Fusion Flare, Earth Power, Focus Blast, Roost
Keldeo: Hydro Pump, Secret Sword, Calm Mind, Hidden Power Ghost, Hidden Power Electric, Substitute, Surf
Meloetta: Relic Song, Close Combat, Calm Mind, Psychic, Thunderbolt, Hyper Voice, U-turn
Genesect: U-turn, Bug Buzz, Ice Beam, Flamethrower, Thunderbolt
